IHHHbHbHHHI
Ib b S b bI
Ib b . b bI
Ib b . b bI
Ib b . b bI
XXXXXGXXXXX
XXXXXXXXXXX
