xxHxxxxxxxxxxxx
X S.  bI    b X
X  .  bI>     X
XHH. HHI .....X
X  .     .b  .X
X  .b ^IH.HHH.X
X b....I..Vb .X
X     .I.b   .X
Xbb   ...   ..X
X Vbb   bbb .bX
X       HHHH.HX
X  HHHHHI.... X
X   <G  I.  bbX
Xb   ..... b  X
xxxxxxxxxxxxxxx
