XXXXXXXXXXXXX
XXXXXXSXXXXXX
I        XXXX
I          XX
I          XX
IH         XX
bI    HHHHHXX
bIb bbbbbbbIb
bIb b  bb bIb
bIb        IH
bI      bbbbb
bIb  bbGbbbbb
bbbbbbb bbbbb
