xxxxxxxxxxxxxxx
X.....bI....b.X
X.S...bI......X
XHH..HHI......X
X.........b...X
X...b..IHHHHH.X
X.b....I...b..X
X......I.G....X
xxxxxxxxxxxxxxx
