xxHxxxxxxxxxxxx
X.S...bI....b.X
X.....bI......X
XHH..HHI......X
X.........b...X
X...b..IHHHHH.X
X.b....I...b..X
X......I.b....X
X.............X
X..bbb..bbb..bX
X.......HHHHHHX
X..HHHHHI.....X
X....G..I...bbX
Xb......I..b..X
xxxxxxxxxxxxxxx
